5444444445
4544444454
4454444544
4445445444
4444664444
4444664444
4445445444
4454444544
4544444454
5444444445
